#################################
#   # #             # #         #
# # # ### ### ####### # ####### #
# # # # # #             #     # #
# ### # ##### ####### ##### #####
# #   #   #     #   # # #       #
# ### # ##### ### #####   ##### #
#             # # # # # ### #   #
# ####### ### # # # # # ### ### #
# #   # #   #                 # #
# # ### ##### ## ## # # ### #####
# #           #   # # #   #     #
# # # # ### ### # # ########### #
# # # #   # #   # #   # # # #   #
### ####### ### ### ### # # #####
# # # #     # #   #     #     # #
#     # # # #   # # # #   # #   #
# # ### # ### ### # # # ### # # #
# #   # # #   #     # #   # # # #
#################################
